+--+--+--+--+--+--+--+--+--+--+
|     |                       |
+  +  +  +--+--+  +--+--+--+--+
|  |  |     |  |              |
+  +--+--+  +  +--+--+--+--+  +
|        |  |        |        |
+  +--+  +  +  +--+  +  +--+  +
|     |  |  |  |     |     |  |
+--+  +  +  +  +  +--+--+  +--+
|     |     |  |  |     |     |
+  +--+--+--+--+  +--+  +--+  +
|     |           |  |  |     |
+--+  +--+--+  +  +  +  +  +--+
|  |           |     |     |  |
+  +--+--+--+--+--+  +--+--+  +
|     |           |  |        |
+  +--+  +--+  +  +  +--+--+  +
|  |     |  |  |  |  |        |
+  +  +--+  +  +--+  +  +--+  +
|           |           |     |
+--+--+--+--+--+--+--+--+--+--+